⬛⬜⬛⬛⬛⬛⬛⬛⬛⬛⬛⬛
⬛⬜⬛⬛⬛⬛⬜⬛⬛⬜⬛⬛
⬛⬜⬜⬜⬜⬜⬜⬜⬜⬜⬜⬛
⬛⬜⬛⬛⬜⬛⬛⬜⬛⬛⬜⬛
⬛⬜⬜⬛⬜⬛⬛⬛⬛⬛⬛⬛
⬛⬜⬛⬛⬜⬜⬜⬜⬜⬜⬛⬛
⬛⬜⬛⬜⬛⬛⬜⬛⬛⬜⬛⬛
⬛⬜⬜⬜⬜⬜⬜⬛⬛⬜⬛⬛
⬛⬛⬛⬛⬜⬛⬛⬛⬛⬜⬛⬛
⬛⬜⬜⬜⬜⬜⬜⬜⬜⬜⬜⬛
⬛⬛⬛⬛⬜⬛⬛⬛⬛⬛⬛⬛
1,0|10,4